                                                            ...  .....::--:....                     
                                                           ..---+*****+++++====-:...                
                                                         ..::==+=-++******+++++++++=:..             
                                                        ..--==::=:+=--:+***************:...         
                                                      ...-+-=+++--=.-===:--=********++===:..        
                                                      .-===++=:+:-==+:-=.=-=-:-===========-.        
                                                    ..:*++--=+++++-:+:===-.-::=============:.       
                                                    .:=+--=+*+*######*+.:==*:--=============.       
                                                   ..-==+=--+*****#####*=::=.---============-.      
                            ......                .-+=+--==-::-+***+####**+-==::-----========..     
                         ...-=---+#+-..          ..-=:==+=....-+=*=**+**.-*.:-:+=-----=======-.     
                     ....----------***+:..       ..-=====-...:=-*+-#+=#+..+++--=-------======-..    
                    ..:--------------+**=...       :--=-+-:::-=:#=-#+-#+..-*=--=--------======:.    
                 ...------------:::---=+**-..      .=+==--+++++-#+=#*-#*...*+--::----------===:.    
                ..-----:::::----:::::--+****:..    .:=--==+***+-*#=##=*#-..+=.-:=-----------==:.    
                :-----:::::------:::-*#####**=..   ..+=+--=++++++#++#*+#*:.*-==:-::---------==:.    
             ..++----:::::::::::--=*######**+:.     .:-+-=-----*+*#**#+*#++*:--:=-----------==:.    
            .-*#**=---::::::::::=#######****...     ..+===+-::.:+=+*=+*+*##+-+--=-----:--=+*#+:.    
        ....********---:::::::+#######****+..       ..---===::..:+**##*###*::--=+=+##########-.     
        ..-**********+--:::-+#######*++**+..        ..:-==-+----=+**###**==-=+-=-+##########-..     
        .=*************+--*#####**####**+...         ..-===+-===++******-=+--=:+*######*##*:.       
      ..=*****+********+*####*==+*#####*++=..         ..=-+=-==+--=-:===:==-+++###*******+..        
      .=++++++++++*****#####+=--=+*#**###**+-..         .:=-==-===+==-:+-+====**********-.          
     .-++++++++++++++*####*--==-+*==**##**#*+=:...       ....:-+-+=-+=+===--****++++++-.            
    ..=++++======+++*####*+=--=*+-++++-*####*+**=.           ....:-+=-+=+*++**++++++=...            
    ..=+++========+#####*##*+**-=*++-=*+**+####*+=:..            ....:====++++==-::..               
     ..:=========+#####*#####*=*+==-*+==-+**##**#*+=...               ......... .                   
        .:======+####**+**###***+=++==-+*=+==*####*++=..                                            
        ...:+++*###*****++*#*###+*++--*=+=:+*+*++###**+=..                                          
            .-*###*****+:.:=*##*##*+=*=+-=+-+-=***##*##*+...                                        
             ...-=*+=:..   .:=*###*#**+-*===-++=+=+#####**+:.                                       
                .....       ..-*#*###***==-++=+--*++*+*###*+-:.                                     
                              ...+###*#**+*=-=:*+=+-=#*##*****-.                                    
                                .:=*+###*#**==+=+==+==+==####**++-..                                
                                 ..:**#*###+**+=-++++--*+****###*+:.                                
                                   ...-*##*###*+*=+--++=*==**####+..                                
                                    ...+***#####**-+*=++-*++**#**#-.                                
                                        .-+*#*###***==-+*+++=+###*:.                                
                                         ..-+*##*###*+*=+==*#***+:.                                 
                                           ..-++###**#*+-=#****+..                                  
                                            ...=+***##*+*#****-.                                    
                                              ...-*###*##***=...                                    
                                                ..-+******=...                                      
                                                      ....

