                                                                          
    .   -=::..::-==   . .                  .                               
         .:-:  ...:--         ..             ....         .                
    .  .     =: ...:=:                    .          .        .     .      
             =. ..::+-       .                                     .       
    *+- .   =. ..:::+-    .       .        .         .    .                
     =. :==:....::-+=+-   .       .           .                       .    
      =:........:-==---+:                            .   .                 
       .+:..:::++==--:..-+-          .                  .           .      
          .+####*+--...:--=+-                            .          .      
         .        .+:..+--===+-.                       .    .              
              .  .  .=..=+:-+==+-              .     .     .               
                       +..-+.:=-=+=    .      .   .  .        .            
                         *..-+..=-=+= .          .                         
    .       .          .   =..-+::+-=+=                                    
         .  .  .           . =:.-+..=-=+=      .                .          
                       ..   .  *:.-+:.=-=+=  .      ..   .        .        
                .                =: -*:.+-==+.       .            .   .    
                           .       -- :+:.=-=++. .   .                     
    . .                     .  .    .=-.:+:.=-==+.             .           
                       .    .          =- :*-.+===+.                       
                    .                    :- :+-.==-=*.      ..   ..        
       .               .    .        ..    :=.:+-.====+:      .  ..        
                  . .         .   .      .   -=.:+=:===-+:    .            
       .               .  .  .   .             :=.:+=.==--*:.              
                   . .  ..  .           .        .+::==.-=--+:             
    .     .      ..                  .           . .+::------=+-           
                                 .  .                .=::--===-===+=:      
          .   .        .. .                       .     *-==-+*-. :+++.    
                                                         .*===      =+*    
                   .. .              .   .       .         ++-      =+*    
        ...             .                      .           :=++. .:*++.    
                                         .    .              ==-==-+-      
                                                                           
