

⠀⠀⠀⢤⠀⠀⠀⠀⠀⠀⠠⣄⠀⠀⠀⠀⠀⠀⠀⠀⠀⠀⠀⠀⠀⢀⡄⠀⠀⠀
⠀⠀⠀⠸⣷⣶⣤⠀⠀⠀⠀⠹⣦⡀⠀⠀⠀⠀⠀⠀⠀⠀⠀⠀⢀⣼⠃⠀⠀⠀
⠀⠀⠰⣿⣿⡅⠀⠀⠀⠀⠀⠀⠘⢷⣤⡀⠀⠀⠀⠀⠀⠀⢀⣠⡿⠃⠀⠀⠀⠀
⠀⠀⠀⣠⣾⣷⡀⠀⠀⠀⠀⠀⠀⠀⣹⡿⠶⣦⣤⣤⣴⡶⠟⠉⠀⠀⠀⠀⠀⠀
⠀⠀⠀⠉⠉⠘⣷⡀⠀⠀⠀⠀⠀⠀⣿⡀⠀⢸⡇⠀⢸⣷⠀⠀⠀⠀⠀⠀⣰⠀
⠀⠀⠀⠀⢠⡿⠟⢷⣴⣾⠇⠀⠀⠀⢘⣷⠀⢺⡇⠀⣿⡁⠀⠀⠀⢀⣠⡾⠃⠀
⠀⣄⡀⠀⠀⠀⠀⠀⠻⣦⣴⣶⠆⠠⠾⠃⠀⠈⠛⠀⠘⣷⣀⣠⣴⣿⠟⠁⠀⠀
⠀⣿⣿⣷⣶⣤⣄⣀⡀⠙⢿⡅⠀⠀⠀⠀⠀⢀⣀⣠⣴⣾⣿⠿⠋⠁⠀⠀⠀⠀
⠀⠙⠻⠿⣿⣿⣿⣿⣿⣿⣿⣿⣷⣶⣾⣿⣿⣿⡿⠿⠛⠉⠀⠀⠀⠀⠀⠀⠀⠀
⠀⠀⠀⠀⠀⠀⠉⠉⠉⠉⠉⠉⠉⠉⠛⢯⣥⣀⠀⠀⠀⢠⣴⣶⠀⠀⠀⠀⠀⠀
⠀⡀⠀⠀⠀⠀⠀⠀⠀⠀⠀⠀⠀⠀⠀⣾⣿⡟⢻⣷⠶⢾⣿⣿⣶⡶⠶⣾⡿⠀
⠀⠻⣦⣀⠀⠀⠀⠀⠀⠀⠀⠀⠀⠀⠀⠛⠉⠀⠸⡿⠀⠀⠀⢀⣠⣴⠞⠉⠀⠀
⠀⢸⡟⠙⢻⣦⣤⣀⣀⠀⠀⠀⠀⠀⠀⠀⠀⢀⣀⣠⣤⡶⢾⡿⠉⣿⠀⠀⠀⠀
⠀⠈⡿⠀⢀⣿⠀⢸⡏⠉⠙⠛⠛⠛⠛⠋⠉⠉⠉⠀⠀⠀⠘⣷⠀⠋⠀⠀⠀⠀
⠀⠀⠀⠀⠈⠁⠀⠈⠋⠀⠀⠀⠀⠀⠀⠀⠀⠀⠀⠀⠀⠀⠀⠀⠀⠀⠀⠀⠀⠀

