                                                                  
                                                                  
               .:                                                 
               .  . ::*::  .                                      
          #- .++:.*%-.. * . =.  -=                                
       ....:. ..:+*=::+%*--*=:.-+.                                
       .  .*==*%@@@@@@@@*%%@%#***=-::::                           
      ...-#@@@@@%@@@@%@@@@@@@@@@@@#.    :                         
   -:::*#%@@@@@@@@@@@@@@@@@@@@@@@@@@@@@@@@@@@@@@@@@%*####==:...:  
 =+#%%@@@@@@@%@@@@@%@@@@@@@@@@@@%@@@@@@@@@@@@@@@@@@@@%%@%%%%%=.   
.+:+@@@@@@@@@@@@@%@@@@@%@@%@@@%@@@@@@@@@@@@@@@@@@@@@@@@@@@@@@@+:  
 :-  *#@@@%@@@@%@@@@@@@@@@@@@@@@@@@%@@@%@@@@@@@%@@%@@@@@@%@@*=:.. 
   =+@@@@@@@@@@@@@@@@@@%%@@@@@%@@@@@@@@%%%%%%%#*==:.=-++=-.:--..  
    ... +@@@@%@@@@@@@%+@*%*+. =.. :                               
     + ..  :=-+..###%%+ .-.+:.   :.                               
            :     .:::. .                                         
                                                                  
